08049aa0         db  0x4e ; 'N'                                                 ; DATA XREF=level_three+23
08049aa1         db  0x00 ; '.'
08049aa2         db  0x00 ; '.'
08049aa3         db  0x00 ; '.'
08049aa4         db  0xcc ; '.'
08049aa5         db  0xff ; '.'
08049aa6         db  0xff ; '.'
08049aa7         db  0xff ; '.'
08049aa8         db  0x6e ; 'n'
08049aa9         db  0x00 ; '.'
08049aaa         db  0x00 ; '.'
08049aab         db  0x00 ; '.'
08049aac         db  0xcc ; '.'
08049aad         db  0xff ; '.'
08049aae         db  0xff ; '.'
08049aaf         db  0xff ; '.'
08049ab0         db  0x4e ; 'N'
08049ab1         db  0x00 ; '.'
08049ab2         db  0x00 ; '.'
08049ab3         db  0x00 ; '.'
08049ab4         db  0xac ; '.'
08049ab5         db  0xff ; '.'
08049ab6         db  0xff ; '.'
08049ab7         db  0xff ; '.'
08049ab8         db  0xcc ; '.'
08049ab9         db  0xff ; '.'
08049aba         db  0xff ; '.'
08049abb         db  0xff ; '.'
08049abc         db  0x04 ; '.'
08049abd         db  0x00 ; '.'
08049abe         db  0x00 ; '.'
08049abf         db  0x00 ; '.'
08049ac0         db  0xcc ; '.'
08049ac1         db  0xff ; '.'
08049ac2         db  0xff ; '.'
08049ac3         db  0xff ; '.'
08049ac4         db  0x76 ; 'v'
08049ac5         db  0x00 ; '.'
08049ac6         db  0x00 ; '.'
08049ac7         db  0x00 ; '.'
08049ac8         db  0x6c ; 'l'
08049ac9         db  0x00 ; '.'
08049aca         db  0x00 ; '.'
08049acb         db  0x00 ; '.'
08049acc         db  0x8c ; '.'
08049acd         db  0xff ; '.'
08049ace         db  0xff ; '.'
08049acf         db  0xff ; '.'
08049ad0         db  0x76 ; 'v'
08049ad1         db  0x00 ; '.'
08049ad2         db  0x00 ; '.'
08049ad3         db  0x00 ; '.'
08049ad4         db  0xcc ; '.'
08049ad5         db  0xff ; '.'
08049ad6         db  0xff ; '.'
08049ad7         db  0xff ; '.'
08049ad8         db  0xcc ; '.'
08049ad9         db  0xff ; '.'
08049ada         db  0xff ; '.'
08049adb         db  0xff ; '.'
08049adc         db  0x4e ; 'N'
08049add         db  0x00 ; '.'
08049ade         db  0x00 ; '.'
08049adf         db  0x00 ; '.'
08049ae0         db  0xac ; '.'
08049ae1         db  0xff ; '.'
08049ae2         db  0xff ; '.'
08049ae3         db  0xff ; '.'
08049ae4         db         "GDB IS NOT ALLOWED!", 0                            ; DATA XREF=level_four+66
